=RedirectWelcomePageServlet
WelcomePage=ShowWelcomePageServlet
HomePage=ShowHomePageServlet
Login=LoginServlet
Logout=LogoutServlet
Register=RegisterNewAccountServlet
SearchCourses=ShowSearchCourseServlet
SinglePage=SinglePage.jsp
MyCourse=ShowMyCoursesServlet
AccountConfirmation=AccountConfirmation.jsp
CreateSuccessfully=CreateSuccessfully.jsp
ValidateNewAccount=ValidateNewAccountServlet
SearchCourse=ShowSearchCoursesServlet
CourseDetail=ShowCourseDetailsServlet
contact=contact.jsp
AddNewRegistration=AddNewRegistrationServlet
ErrorPage=error.html
StartLearning=ShowLearningLessonsServlet
Profile=ProfilePage.jsp
Dashboard=Dashboard.jsp
UserTable=ViewUserServlet
GetProfile=GetUserProfileServlet
ClearProfileCache=ClearProfileSessionServlet
UpdateUser=UpdateUserServlet
UpdateUserProfile=UpdateUserProfileServlet
SubjectTable=ShowSubjectsListServlet
AddNewSubject=AddNewSubjectServlet
UpdateSubjectDetails=UpdateSubjectDetailsServlet
AddNewLesson=AddNewLessonServlet
UpdateLesson=UpdateLessonDetailsServlet
AddNewPackage=AddNewPackageServlet
UpdatePackage=UpdateCurrentPackageServlet
TakeQuiz=GetQuizQuestionServlet
PostDetails=ShowPostDetailsServlet
PostTable=ShowPostListServlet
GetEditSubjectInfo=GetSubjectForUpdatingServlet
GetEditPackageInfo=GetPackageForUpdatingServlet
GetEditLessonInfo=GetLessonForUpdatingServlet
AddNewUser=AddNewAccountServlet
ShowResult=ShowResultServlet
Lectures=Lectures.jsp
QuizTable=GetQuizListtServlet
ChangeQuizStatus=ChangeQuizStatusServlet
GetQuizList=GetQuizListtServlet
MakeQuiz=MakeQuizServlet
GetQuizInfo=GetQuizInfoServlet
UpdateQuiz=UpdateQuizServlet
TrackingProgress=TrackingProgressServlet
QuestionTable=DashboardQuestionTable.jsp
SearchByCategory=SearchCoursesServlet
ImportQuestions=DashboardImportQuestion.jsp
ProcessUploadQuestions=UploadQuestionsServlet
AddNewQuestions=AddQuestionsViaImportServlet